20,20,20,20,20,20,35,36,37,39,20,20,20,20,20,20,20,20,20,20,20,20,20,20,20,20,20,20,20,20
20,35,36,36,37,38,43,00,00,42,39,20,20,20,20,20,20,20,20,20,20,20,20,20,20,20,20,20,20,20
20,45,00,00,00,00,00,00,00,00,49,20,20,20,20,20,20,20,20,20,20,20,20,20,20,20,20,20,20,20
20,45,00,00,00,40,31,32,33,33,34,20,20,20,20,20,20,20,20,20,20,20,20,20,20,20,20,20,20,20
20,45,00,40,32,34,20,20,20,20,20,20,20,20,20,20,35,36,37,38,36,37,38,39,20,20,20,20,20,20
20,45,00,49,20,20,20,20,20,20,20,20,20,20,35,36,43,00,00,00,00,00,00,42,38,39,20,20,20,20
20,45,00,42,39,20,20,20,20,20,20,20,20,35,43,00,00,00,00,00,00,00,00,00,00,49,20,20,20,20
20,45,00,00,42,36,39,20,20,20,20,20,20,45,00,00,00,00,10,10,10,00,00,00,00,49,20,20,20,20
20,45,00,00,00,00,42,37,39,20,20,20,35,43,00,00,00,10,10,10,10,10,00,00,00,42,39,20,20,20
20,45,00,00,00,00,00,00,42,39,20,20,45,00,00,00,10,10,10,10,10,10,10,00,00,00,49,20,20,20
20,45,00,00,00,10,00,00,00,49,20,20,45,00,00,00,10,10,10,10,10,10,10,00,00,00,49,20,20,20
20,45,00,10,10,10,10,10,00,42,39,20,45,00,00,00,00,10,10,10,10,10,10,10,00,00,49,20,20,20
20,45,00,10,10,10,10,10,00,00,49,20,30,41,00,00,00,00,10,10,10,10,10,00,00,00,49,20,20,20
20,45,00,10,10,10,10,10,10,00,42,39,20,30,41,00,00,00,00,00,00,00,00,00,00,40,34,20,20,20
20,45,00,10,10,10,10,10,10,00,00,49,20,20,30,33,31,33,41,00,00,00,00,00,40,34,20,20,20,20
20,45,00,10,10,10,10,10,00,00,00,49,20,20,20,20,20,20,30,32,41,00,00,40,34,20,20,20,20,20
20,45,00,10,10,10,10,10,00,00,40,34,20,20,20,20,20,20,20,20,30,31,33,34,20,20,20,20,20,20
20,45,00,00,00,00,00,00,00,00,49,20,20,20,20,20,20,20,20,20,20,20,20,20,20,20,20,20,20,20
20,30,31,32,31,32,31,31,32,33,34,20,20,20,20,20,20,20,20,20,20,20,20,20,20,20,20,20,20,20
20,20,20,20,20,20,20,20,20,20,20,20,20,20,20,20,20,20,20,20,20,20,20,20,20,20,20,20,20,20
